D51535D5155515759577
ACA4A3ACA2ACA6A9A6AF
B5E5C5758575E5D525B7
A7AFAEADA2ABABA8A1A7
A5B5F5F5855515554567
A5A7ABADA2ACA6AAAEAF
A5A595758535A59575B7
A5A1A2ADA4A5A1A2A9A7
A5854575E5E585055527
A5A2AAAFAFA9A4A2ACA7
A5851575B5D525C535A7
A5A4A2A9A7A8A3ACA5A7
E5A5C51565D54535A5E7
A9A3ACA2ABAAACA5A3AF
95053585155575A58537
A4A4A5A4A2AAADA5A4A7
A5E5E5E5855535A5A5A7
A3ABAFA9A2ACA5A5A5A7
C51575954535E5E5E5E7
A8A2ADA2ACA3ABABABAF
D5453585358515155577
AAACA5A4A5A4A4A2AAAF
D535A5A5E5A5A5855537
A8A1A5A7A9A5A5A2ACA7
D50525A5D525A58535A7
A8A4A5A7A8A5A5A4A5A7
9525E5A5D525A5A5E5E7
A4A7A9A3ACA5A5A3ABAF
A5E5D50535A5A5C51537
A3ABACA4A5A5A3ACA4A7
C55575E5E5E5C575E5E7
EEEEEFEFEFEFEEEFEFEF

1,1
19,31
