B5D5155575B59575B59575B5B5B5B5B
A3A8A6AEA9A1A2A9A1A6A9A5A5A1A1A
855565B5D505455545659565A5C5056
A2AAA9A3ACA2AEAEAEADA6ADA3ACA2A
C5151545758575B5B5B5A5B58575857
A8A4A6AAA9A2ADA5A1A1A5A5A2A9A6A
D525A595554575A5854565A5855565B
A8A5A1A2AAAEA9A1A2AAADA1A2AEA9A
D565C5055575D505451575854575956
AAABA8A2AAABA8A2ACA2A9A2AAADA2A
951515051515154575C515451575857
A4A4A4A4A4A4A2AAAFA8A2ACA2A9A2A
A5A5A5E5A5A5C51575D54535C555457
A5A5A7A9A5A7A8A2ABAAACA7AAAAAAA
A5A5E5D565A5D505155535E5D515557
A5A7AFAAA9A7A8A4A6A8A3ABA8A2AAA
E5E5B5955525D565A59545155545557
ABADA1A6A8A3AAADA5A2ACA2AAAAAAA
D535C525D5055535E5C575C55515553
ACA3A8A3ACA2ACA3ABAAABAEACA2ACA
B5C5150535C5358515555575B5C575E
A3A8A4A4A7A8A5A4A2AEAAA9A3AEAFA
C55565E5E59565A5853595554535B5B
AAAAABABADA2ADA5A4A1A2AAACA1A1A
95155515358575A5A5C505157585056
A4A6A8A4A1A6A9A5A3ACA4A6ADA4A6A
E5E59525C525D565C535E5A5B5E5E5B
ABA9A4A7A8A7AAABA8A7A9A1A3ABA9A
D51565E5D525D5151525D5054555152
A8A6ABABA8A3ACA4A4A7A8A2AAACA4A
D565D555554575E5E5E5D5455575E5E

7,23
7,7
