955575D55575953
A6AAABAEAAADA4A
E5D55575D535A5E
ABAEAEAFA8A1A3A
D535B5F59505453
A8A5A3A9A4A2ACA
D565855565C575E
AAA9A2AAABAAABA
D51505151555153
A8A4A4A4A2ACA4A
D565A5A58535E5A
AAA9A5A5A4A3ADA
D51525A5E58575E
A8A4A5A3ADA2ABA
D565E5C575C5557

1,1
3,10
